5 5
@@@@@
@...@
@.@.@
@...@
@@@@@
1 1
3
3 3
2 3
3 2