5 10
@@@@@@@@@@
@...@..@.@
@.@.@....@
@.....@..@
@@@@@@@@@@
1 1
4
1 8
1 6
2 3
3 5