6 10
@@@@@@@@@@
@...@..@.@
@.@.@....@
@.....@..@
@@@@@...@@
@@@@@@@@@@
1 1
5
1 8
1 6
2 3
3 5
4 7